R 1920 1080  
NO       ./textures/eagle.xpm
SO ./textures/wood.xpm

WE    ./textures/greystone.xpm
EA ./textures/redbrick_1.xpm

S ./textures/1_1.xpm
F              21, 70, 50
C    255,255,1

11    1111111111111111111111111111          
101   1000000000110000000000001   111
 1    1011000201110002002000001   101
      100102020000000000000000111 111
111111111011020001110000000000001
100000000011000001110111111111111
11110111111111011100000000011
11110111111111011101010010001
11000000110101011100020010101 
100002020000000002110002010001
10020000020200001101010010001   11  
1100E00111010101111101111000111 101
11110111 1110101 101111010001   11           1
11111111 1111111 111111111111




