R 1920  1080
NO       ./textures/eagle.xpm
SO ./textures/wood.xpm
WE    ./textures/greystone.xpm
EA ./textures/redbrick_1.xpm

S ./textures/barrel.xpm
F 121, 132, 130 
C 188, 190, 233





        1111111111111111111111111
        1000000000110000000000001   111
        1011000001110000002000001   101
        1001020000000000000000001   111
111111111011000001110000000000001
100000000011000001110111111111111
11110111111111011100000100011
11110111111111011101010010001
11000000110101011100000010001
10000200000000000110000010001
10000000020020001101010010001
1100N00111010101111101111000111
11110111 1110101 101111010001
11111111 1111111 111111111111




